disappointed::rozczarowany
farm::gospodarstwo
to get scared::przestraszyć się
to be raised::wychować/wychowywać się
parents-in-law::teściowie
newly born::nowonarodzony
tablecloth::obrus
to feed::(na)karmić
spices::przyprawy
stuffed::nadziewane
sad/down::przygnębiony
crowd::tłum
24/7::całodobowy
volleyball::siatkówka
stain::plama
to regret::żałować
motor::silnik
to not care::mieć coś w nosie
to interrupt::przerywać/przerwać
indifferent::obojętnie
transparent::przezroczysty
a relationship::związek
roommate::współlokatorka
to take off::zdejmować/zdjąć
furious::wściekły
silence::milczenie
suddenly::nagle
to expect::spodziewać się
neighborhood::okolica
to earn::zarabiać/zarobić