a reason::powód
surprise::niespodzianka
purse::torebka
granddaughter::wnuczka
reason::powód
candy::cukierek
square (place)::plac
brilliant::rewelacyjny
grandson::wnuk
a lot of::sporo
since::skoro
team::ekipa
gesture::gest
a lot more::dużo więcej
vocabulary::słownictwo
to avoid::uniknąć
repetition::powtórzenie
synonym::synonim
to insist::nalegać
usefulness::przydatność
fantastic::fantastyczny
well rested::wyspany
to get enough sleep::wyspać się
stunning::oszałamiający
epic::epicki
to come (over)::przyść
friendly::sympatyczny
top notch::pierwsza klasa
for rent::do wynajęcia
scorching (hot)::upalny
unbearable::nie do zniesienia
cute::uroczy
quite good::całkiem, całkiem
awesome::ekstra
at the same time::jednocześnie
excellent::znakomity
to burn::spalić
decent::zacny
pretty good::niczego sobie
charming::urokliwy
fabulous::bajeczny
groovy::szałowy
definitely::zdecydowanie
to miss out::przegapić
serious::poważny
crude::surowy
mild, gentle::łagodny
usually::zazwyczaj
to pronounce::wymawiać
separate::oddzielny
main::główny
pavement::chodnik
crime::przestępstwo
playground::plac zabaw
humid::wilgotny
himidity::wilgotność
to cancel::odwołać
to comb (hair)::uczesać się
one's appearance::wygląd
a mess::bałagan
to summarize::podsumować
a summary::podsumowanie
a saying::powiedzonko
to replace::wymienić
at first glance::na pierwszy rzut oka
stairs::schody
ancestor::przodek
to borrow::zapożyczać
rebellion::bunt
feature::cecha
still::ciągle
cleavage::dekolt
income::dochód
convinced::przekonany
zoo::zwierzyniec
from above::znad
puzzle::zagadka
to blow::dmuchać
honest::szczery
social::społeczny
shy::nieśmiały
reality::rzeczywistość
variety::różnorodność
to recognize::rozpoznać
nature::przyroda
average::przeciętny
discovery::odkrycie
outrageous::oburzające
delicious::wyborny
perseverance::wytrwałość
logic::logika
to replace::zastąpić
a small gesture::drobny gest
community::społeczność
balance::równowaga
invention::wynalazek
term (word)::określenie
to multiply::mnożyć
literally::dosłownie
a suggestion::sugestia
useful::przydatny
pleasure::przyjemność
bench::ławka
birds eye view::widok z lotu ptaka
pretty::śliczny
adjective::przymiotnik
to notice::zauważyć
eyesight::wzrok
mostly::przeważnie
muffin::bułeczka
coffee pot::kawiarka
to rinse, scrub::przemyć
to wash::umyć
a kiss::buziak
croissant::rogalik
order (sequence)::kolejność
activities::zajęcia
remotely::zdalnie
only (sole)::jedyny
exclusive::wyłączny
to catch::łapać
to stand up (get up)::wstać
successful::udany
somehow::jakoś
to wake up::obudzić się
to check::sprawdzić
to make the bed::ścielić łóżko
after waking up::po przebudzeniu
former::były
last (before this one)::zeszły
current::obecny
present (tense)::teraźniejszy
future::przyszły
past::przeszły
sold out::wysprzedany
abundance::obfitość
designed for...::obliczony na
service::obsługa
two times as much as::dwa razy tyle, co
to cool::chłodzić
to possess (have)::posiadać
significantly::znacznie
forbidden::zabroniony
freely::swobodnie
flaw (defect)::wada
surroundings::otoczenia
to stress out::zestresować
to catch up with sth::nadrobić coś
demanding::roszczeniowy
to deal with sth::poradzić sobie z czymś
spouse::małżonek
to imagine::wyobrażać sobie
nation::naród
main reason::główny powód
pandemic::pandemia
to solve::rozwiązać
under control::pod kontrolą
technically::zasadniczo
solution::rozwiązanie
to lose a job::stracić pracę
stressful::stresujący
that's sth I'm passionate about::to mnie kręci
hobby::pasja
escape::ucieczka
rational::racjonalny
opportunity::możliwość
it looks like it's going to rain::zbiera się na deszcz
upsetting::przykry
rabbit::królik
quarantine::kwarantanna
prison::więzienie
rape::gwałt
rash::wysypka
raspberry::malina
absolutely::absolutnie
regularly::regularnie
to meditate::medytować
drowsy::przymulony
to waste time::pożeracz czasu
air::powietrze
to irritate sb::poddenerwować
to ruin::zepsuć
to avoid::unikać
a push-up::pompka
morning routine::poranna rutyna
classes::zajęcia
to check::sprawdzać
fresh::świeży
to scroll through::przeglądać
social media::media społecznościowe
preposition::przyimek
noun::rzeczownik
verb::czasownik
adverb::przysłówek

