powód::a reason
niespodzianka::surprise
torebka::purse
wnuczka::granddaughter
powód::reason
cukierek::candy
plac::square (place)
rewelacyjny::brilliant
wnuk::grandson
sporo::a lot of
skoro::since
ekipa::team
gest::gesture
dużo więcej::a lot more
słownictwo::vocabulary
uniknąć::to avoid
powtórzenie::repetition
synonim::synonym
nalegać::to insist
przydatność::usefulness
fantastyczny::fantastic
wyspany::well rested
wyspać się::to get enough sleep
oszałamiający::stunning
epicki::epic
przyść::to come (over)
sympatyczny::friendly
pierwsza klasa::top notch
do wynajęcia::for rent
upalny::scorching (hot)
nie do zniesienia::unbearable
uroczy::cute
całkiem, całkiem::quite good
ekstra::awesome
jednocześnie::at the same time
znakomity::excellent
spalić::to burn
zacny::decent
niczego sobie::pretty good
urokliwy::charming
bajeczny::fabulous
szałowy::groovy
zdecydowanie::definitely
przegapić::to miss out
poważny::serious
surowy::crude
łagodny::mild, gentle
zazwyczaj::usually
wymawiać::to pronounce
oddzielny::separate
główny::main
chodnik::pavement
przestępstwo::crime
plac zabaw::playground
wilgotny::humid
wilgotność::himidity
odwołać::to cancel
uczesać się::to comb (hair)
wygląd::one's appearance
bałagan::a mess
podsumować::to summarize
podsumowanie::a summary
powiedzonko::a saying
wymienić::to replace
na pierwszy rzut oka::at first glance
schody::stairs
przodek::ancestor
zapożyczać::to borrow
bunt::rebellion
cecha::feature
ciągle::still
dekolt::cleavage
dochód::income
przekonany::convinced
zwierzyniec::zoo
znad::from above
zagadka::puzzle
dmuchać::to blow
szczery::honest
społeczny::social
nieśmiały::shy
rzeczywistość::reality
różnorodność::variety
rozpoznać::to recognize
przyroda::nature
przeciętny::average
odkrycie::discovery
oburzające::outrageous
wyborny::delicious
wytrwałość::perseverance
logika::logic
zastąpić::to replace
drobny gest::a small gesture
społeczność::community
równowaga::balance
wynalazek::invention
określenie::term (word)
mnożyć::to multiply
dosłownie::literally
sugestia::a suggestion
przydatny::useful
przyjemność::pleasure
ławka::bench
widok z lotu ptaka::birds eye view
śliczny::pretty
przymiotnik::adjective
zauważyć::to notice
wzrok::eyesight
przeważnie::mostly
bułeczka::muffin
kawiarka::coffee pot
przemyć::to rinse, scrub
umyć::to wash
buziak::a kiss
rogalik::croissant